; Reference: http://www.sokobano.de/wiki/index.php?title=Level_format

Lv1:
#######
#. $ .#
# $@$ #
#. $ .#
#######

Lv2:
########
#  ..$ #
# $@ $ #
# $..  #
########

Lv3:
 #######
 #     #
## .$. #
#@ $ $ #
#  .$. #
##     #
 #######

Lv4:
 #####
##   ###
#  #   #
# #  # #
# $ $# #
#.#    #
#. @####
#####

Lv5:
########
# $. $.#
#@.$ $.#
# $. $.#
# .$ $.#
########

Lv6:
   #######
  ##  # @#
  #   #  #
  #$ $ $ #
  # $##  #
### $ # ##
#.....  #
#########

Lv7:
#########
#   *   #
# $.#.$ #
#  $.$  #
###.$.###
  ##@##
   ###

Lv8:
  #####
###   #
#@ .$.#
#  $ $#
###.$.#
  #   #
  #####

Lv9:
  ####
  #  #
###  #####
#  ..$   #
#@$.. $  #
### $#####
  #  #
  ####

Lv10:
 #########
##       #
#   #$#$ #
# $$  .$.#
# @###...#
#### #####

Lv11:
 ##########
##   #@   ##
# $ ....$  #
#  $#### $ #
#   #  #  ##
#####  ####
